銀行	第一類帳戶	第二類帳戶	第三類帳戶	合計	年份	季度	年季	年月	類型
臺灣銀行	14998 	74496 	17093 	106587 	2022	Q3	2022-Q3	22-Sep	公股行庫
臺灣土地銀行	12665 	77578 	100144 	190387 	2022	Q3	2022-Q3	22-Sep	公股行庫
合作金庫商業銀行	16541 	126616 	302878 	446035 	2022	Q3	2022-Q3	22-Sep	公股行庫
第一商業銀行	174554 	630534 	249002 	1054090 	2022	Q3	2022-Q3	22-Sep	公股行庫
華南商業銀行	19138 	443913 	52853 	515904 	2022	Q3	2022-Q3	22-Sep	公股行庫
彰化商業銀行	223003 	96863 	186650 	506516 	2022	Q3	2022-Q3	22-Sep	公股行庫
上海商業儲蓄銀行	1743 	24207 	61999 	87949 	2022	Q3	2022-Q3	22-Sep	民營銀行
台北富邦商業銀行	25502 	65409 	261940 	352851 	2022	Q3	2022-Q3	22-Sep	民營銀行
國泰世華商業銀行	289435 	997933 	416772 	1704140 	2022	Q3	2022-Q3	22-Sep	民營銀行
高雄銀行	256 	1432 	15296 	16984 	2022	Q3	2022-Q3	22-Sep	民營銀行
兆豐國際商業銀行	27834 	78734 	78490 	185058 	2022	Q3	2022-Q3	22-Sep	公股行庫
花旗(台灣)商業銀行	3274 	0 	8812 	12086 	2022	Q3	2022-Q3	22-Sep	民營銀行
王道商業銀行	82836 	0 	402386 	485222 	2022	Q3	2022-Q3	22-Sep	民營銀行
臺灣中小企業銀行	14516 	28228 	25081 	67825 	2022	Q3	2022-Q3	22-Sep	公股行庫
渣打國際商業銀行	3239 	813 	18138 	22190 	2022	Q3	2022-Q3	22-Sep	民營銀行
台中商業銀行	0 	111 	0 	111 	2022	Q3	2022-Q3	22-Sep	民營銀行
京城商業銀行	1042 	3477 	22948 	27467 	2022	Q3	2022-Q3	22-Sep	民營銀行
?豐(台灣)商業銀行	13698 	0 	19546 	33244 	2022	Q3	2022-Q3	22-Sep	民營銀行
瑞興商業銀行	76 	0 	581 	657 	2022	Q3	2022-Q3	22-Sep	民營銀行
華泰商業銀行	29 	0 	161 	190 	2022	Q3	2022-Q3	22-Sep	民營銀行
臺灣新光商業銀行	10041 	1139 	164383 	175563 	2022	Q3	2022-Q3	22-Sep	民營銀行
陽信商業銀行	1186 	1758 	1490 	4434 	2022	Q3	2022-Q3	22-Sep	民營銀行
板信商業銀行	0 	21 	0 	21 	2022	Q3	2022-Q3	22-Sep	民營銀行
三信商業銀行	276 	0 	341 	617 	2022	Q3	2022-Q3	22-Sep	民營銀行
聯邦商業銀行	78571 	0 	309263 	387834 	2022	Q3	2022-Q3	22-Sep	民營銀行
遠東國際商業銀行	22181 	15972 	126821 	164974 	2022	Q3	2022-Q3	22-Sep	民營銀行
元大商業銀行	538 	7268 	28980 	36786 	2022	Q3	2022-Q3	22-Sep	民營銀行
永豐商業銀行	517886 	284091 	496996 	1298973 	2022	Q3	2022-Q3	22-Sep	民營銀行
玉山商業銀行	101620 	110746 	300449 	512815 	2022	Q3	2022-Q3	22-Sep	民營銀行
凱基商業銀行	501 	0 	29984 	30485 	2022	Q3	2022-Q3	22-Sep	民營銀行
星展(台灣)商業銀行	0 	0 	5549 	5549 	2022	Q3	2022-Q3	22-Sep	民營銀行
台新國際商業銀行	1104633 	662752 	1152134 	2919519 	2022	Q3	2022-Q3	22-Sep	民營銀行
日盛國際商業銀行	0 	105 	61 	166 	2022	Q3	2022-Q3	22-Sep	民營銀行
安泰商業銀行	1700 	1633 	3494 	6827 	2022	Q3	2022-Q3	22-Sep	民營銀行
中國信託商業銀行	62278 	321465 	487579 	871322 	2022	Q3	2022-Q3	22-Sep	民營銀行
將來商業銀行	6400 	0 	181481 	187881 	2022	Q3	2022-Q3	22-Sep	純網銀
連線商業銀行	36226 	0 	1276117 	1312343 	2022	Q3	2022-Q3	22-Sep	純網銀
樂天國際商業銀行	19844 	0 	104015 	123859 	2022	Q3	2022-Q3	22-Sep	純網銀
臺灣銀行	13372 	59895 	10853 	84120 	2022	Q2	2022-Q2	22-Jun	公股行庫
臺灣土地銀行	11791 	68574 	92304 	172669 	2022	Q2	2022-Q2	22-Jun	公股行庫
合作金庫商業銀行	16312 	108757 	270665 	395734 	2022	Q2	2022-Q2	22-Jun	公股行庫
第一商業銀行	155378 	591474 	235012 	981864 	2022	Q2	2022-Q2	22-Jun	公股行庫
華南商業銀行	18207 	402195 	44349 	464751 	2022	Q2	2022-Q2	22-Jun	公股行庫
彰化商業銀行	190580 	89170 	169986 	449736 	2022	Q2	2022-Q2	22-Jun	公股行庫
上海商業儲蓄銀行	1746 	21342 	53707 	76795 	2022	Q2	2022-Q2	22-Jun	民營銀行
台北富邦商業銀行	23219 	58499 	226413 	308131 	2022	Q2	2022-Q2	22-Jun	民營銀行
國泰世華商業銀行	276066 	991413 	348590 	1616069 	2022	Q2	2022-Q2	22-Jun	民營銀行
高雄銀行	110 	1422 	13558 	15090 	2022	Q2	2022-Q2	22-Jun	民營銀行
兆豐國際商業銀行	26716 	57780 	59836 	144332 	2022	Q2	2022-Q2	22-Jun	公股行庫
花旗(台灣)商業銀行	3098 	0 	8185 	11283 	2022	Q2	2022-Q2	22-Jun	民營銀行
王道商業銀行	82044 	0 	398076 	480120 	2022	Q2	2022-Q2	22-Jun	民營銀行
臺灣中小企業銀行	12725 	24089 	23072 	59886 	2022	Q2	2022-Q2	22-Jun	公股行庫
渣打國際商業銀行	3206 	798 	16873 	20877 	2022	Q2	2022-Q2	22-Jun	民營銀行
台中商業銀行	0 	113 	0 	113 	2022	Q2	2022-Q2	22-Jun	民營銀行
京城商業銀行	931 	2890 	19369 	23190 	2022	Q2	2022-Q2	22-Jun	民營銀行
?豐(台灣)商業銀行	13406 	0 	13625 	27031 	2022	Q2	2022-Q2	22-Jun	民營銀行
瑞興商業銀行	75 	0 	605 	680 	2022	Q2	2022-Q2	22-Jun	民營銀行
華泰商業銀行	26 	0 	131 	157 	2022	Q2	2022-Q2	22-Jun	民營銀行
臺灣新光商業銀行	5463 	1148 	136791 	143402 	2022	Q2	2022-Q2	22-Jun	民營銀行
陽信商業銀行	1081 	1715 	1191 	3987 	2022	Q2	2022-Q2	22-Jun	民營銀行
板信商業銀行	0 	21 	0 	21 	2022	Q2	2022-Q2	22-Jun	民營銀行
三信商業銀行	256 	0 	279 	535 	2022	Q2	2022-Q2	22-Jun	民營銀行
聯邦商業銀行	74976 	0 	286052 	361028 	2022	Q2	2022-Q2	22-Jun	民營銀行
遠東國際商業銀行	19274 	14964 	119095 	153333 	2022	Q2	2022-Q2	22-Jun	民營銀行
元大商業銀行	317 	5839 	21326 	27482 	2022	Q2	2022-Q2	22-Jun	民營銀行
永豐商業銀行	486673 	273513 	483413 	1243599 	2022	Q2	2022-Q2	22-Jun	民營銀行
玉山商業銀行	96965 	94462 	256821 	448248 	2022	Q2	2022-Q2	22-Jun	民營銀行
凱基商業銀行	503 	0 	26529 	27032 	2022	Q2	2022-Q2	22-Jun	民營銀行
星展(台灣)商業銀行	0 	0 	5417 	5417 	2022	Q2	2022-Q2	22-Jun	民營銀行
台新國際商業銀行	1105241 	658308 	1081888 	2845437 	2022	Q2	2022-Q2	22-Jun	民營銀行
日盛國際商業銀行	0 	105 	61 	166 	2022	Q2	2022-Q2	22-Jun	民營銀行
安泰商業銀行	1292 	1570 	3336 	6198 	2022	Q2	2022-Q2	22-Jun	民營銀行
中國信託商業銀行	56237 	271284 	418748 	746269 	2022	Q2	2022-Q2	22-Jun	民營銀行
將來商業銀行	4357 	0 	97521 	101878 	2022	Q2	2022-Q2	22-Jun	純網銀
連線商業銀行	32567 	0 	1197677 	1230244 	2022	Q2	2022-Q2	22-Jun	純網銀
樂天國際商業銀行	17284 	0 	74229 	91513 	2022	Q2	2022-Q2	22-Jun	純網銀
臺灣銀行	11059 	42938 	5148 	59145 	2022	Q1	2022-Q1	22-Mar	公股行庫
臺灣土地銀行	10919 	61152 	84804 	156875 	2022	Q1	2022-Q1	22-Mar	公股行庫
合作金庫商業銀行	15964 	90522 	239918 	346404 	2022	Q1	2022-Q1	22-Mar	公股行庫
第一商業銀行	136158 	554548 	220178 	910884 	2022	Q1	2022-Q1	22-Mar	公股行庫
華南商業銀行	16555 	357535 	34225 	408315 	2022	Q1	2022-Q1	22-Mar	公股行庫
彰化商業銀行	163173 	82801 	155235 	401209 	2022	Q1	2022-Q1	22-Mar	公股行庫
上海商業儲蓄銀行	1749 	19992 	49520 	71261 	2022	Q1	2022-Q1	22-Mar	民營銀行
台北富邦商業銀行	20449 	52983 	188621 	262053 	2022	Q1	2022-Q1	22-Mar	民營銀行
國泰世華商業銀行	262760 	982270 	290482 	1535512 	2022	Q1	2022-Q1	22-Mar	民營銀行
高雄銀行	46 	1416 	12768 	14230 	2022	Q1	2022-Q1	22-Mar	民營銀行
兆豐國際商業銀行	26057 	51757 	53971 	131785 	2022	Q1	2022-Q1	22-Mar	公股行庫
花旗(台灣)商業銀行	2874 	0 	7442 	10316 	2022	Q1	2022-Q1	22-Mar	民營銀行
王道商業銀行	81199 	0 	393879 	475078 	2022	Q1	2022-Q1	22-Mar	民營銀行
臺灣中小企業銀行	10783 	18465 	19858 	49106 	2022	Q1	2022-Q1	22-Mar	公股行庫
渣打國際商業銀行	3160 	791 	15718 	19669 	2022	Q1	2022-Q1	22-Mar	民營銀行
台中商業銀行	0 	115 	0 	115 	2022	Q1	2022-Q1	22-Mar	民營銀行
京城商業銀行	791 	2320 	16442 	19553 	2022	Q1	2022-Q1	22-Mar	民營銀行
?豐(台灣)商業銀行	13220 	0 	8796 	22016 	2022	Q1	2022-Q1	22-Mar	民營銀行
瑞興商業銀行	69 	0 	557 	626 	2022	Q1	2022-Q1	22-Mar	民營銀行
華泰商業銀行	26 	0 	113 	139 	2022	Q1	2022-Q1	22-Mar	民營銀行
臺灣新光商業銀行	4723 	1153 	102890 	108766 	2022	Q1	2022-Q1	22-Mar	民營銀行
陽信商業銀行	1030 	1688 	981 	3699 	2022	Q1	2022-Q1	22-Mar	民營銀行
板信商業銀行	0 	21 	0 	21 	2022	Q1	2022-Q1	22-Mar	民營銀行
三信商業銀行	233 	0 	228 	461 	2022	Q1	2022-Q1	22-Mar	民營銀行
聯邦商業銀行	71867 	0 	269267 	341134 	2022	Q1	2022-Q1	22-Mar	民營銀行
遠東國際商業銀行	14702 	13952 	109178 	137832 	2022	Q1	2022-Q1	22-Mar	民營銀行
元大商業銀行	212 	4131 	13468 	17811 	2022	Q1	2022-Q1	22-Mar	民營銀行
永豐商業銀行	452255 	262055 	468051 	1182361 	2022	Q1	2022-Q1	22-Mar	民營銀行
玉山商業銀行	93463 	72888 	213065 	379416 	2022	Q1	2022-Q1	22-Mar	民營銀行
凱基商業銀行	503 	0 	23021 	23524 	2022	Q1	2022-Q1	22-Mar	民營銀行
星展(台灣)商業銀行	0 	0 	5239 	5239 	2022	Q1	2022-Q1	22-Mar	民營銀行
台新國際商業銀行	1107874 	650857 	1041628 	2800359 	2022	Q1	2022-Q1	22-Mar	民營銀行
日盛國際商業銀行	0 	100 	61 	161 	2022	Q1	2022-Q1	22-Mar	民營銀行
安泰商業銀行	1232 	1550 	3244 	6026 	2022	Q1	2022-Q1	22-Mar	民營銀行
中國信託商業銀行	48183 	245881 	360435 	654499 	2022	Q1	2022-Q1	22-Mar	民營銀行
將來商業銀行	429 	0 	8236 	8665 	2022	Q1	2022-Q1	22-Mar	純網銀
連線商業銀行	27360 	0 	1081814 	1109174 	2022	Q1	2022-Q1	22-Mar	純網銀
樂天國際商業銀行	14415 	0 	61652 	76067 	2022	Q1	2022-Q1	22-Mar	純網銀
臺灣銀行	9441 	29243 	2472 	41156 	2021	Q4	2021-Q4	21-Dec	公股行庫
臺灣土地銀行	7927 	54456 	43132 	105515 	2021	Q4	2021-Q4	21-Dec	公股行庫
合作金庫商業銀行	15331 	72822 	209993 	298146 	2021	Q4	2021-Q4	21-Dec	公股行庫
第一商業銀行	114582 	506288 	192970 	813840 	2021	Q4	2021-Q4	21-Dec	公股行庫
華南商業銀行	15677 	320080 	26892 	362649 	2021	Q4	2021-Q4	21-Dec	公股行庫
彰化商業銀行	134086 	74207 	133516 	341809 	2021	Q4	2021-Q4	21-Dec	公股行庫
上海商業儲蓄銀行	1749 	17478 	42463 	61690 	2021	Q4	2021-Q4	21-Dec	民營銀行
台北富邦商業銀行	17594 	42620 	148681 	208895 	2021	Q4	2021-Q4	21-Dec	民營銀行
國泰世華商業銀行	245280 	977490 	227953 	1450723 	2021	Q4	2021-Q4	21-Dec	民營銀行
高雄銀行	44 	1414 	9654 	11112 	2021	Q4	2021-Q4	21-Dec	民營銀行
兆豐國際商業銀行	25419 	48689 	49859 	123967 	2021	Q4	2021-Q4	21-Dec	公股行庫
花旗(台灣)商業銀行	2638 	0 	6857 	9495 	2021	Q4	2021-Q4	21-Dec	民營銀行
王道商業銀行	80315 	0 	390697 	471012 	2021	Q4	2021-Q4	21-Dec	民營銀行
臺灣中小企業銀行	7508 	10879 	11666 	30053 	2021	Q4	2021-Q4	21-Dec	公股行庫
渣打國際商業銀行	5795 	1344 	25109 	32248 	2021	Q4	2021-Q4	21-Dec	民營銀行
台中商業銀行	0 	115 	0 	115 	2021	Q4	2021-Q4	21-Dec	民營銀行
京城商業銀行	647 	1848 	13586 	16081 	2021	Q4	2021-Q4	21-Dec	民營銀行
?豐(台灣)商業銀行	10967 	0 	6152 	17119 	2021	Q4	2021-Q4	21-Dec	民營銀行
瑞興商業銀行	67 	0 	520 	587 	2021	Q4	2021-Q4	21-Dec	民營銀行
華泰商業銀行	22 	0 	78 	100 	2021	Q4	2021-Q4	21-Dec	民營銀行
臺灣新光商業銀行	4448 	1166 	86331 	91945 	2021	Q4	2021-Q4	21-Dec	民營銀行
陽信商業銀行	970 	1656 	785 	3411 	2021	Q4	2021-Q4	21-Dec	民營銀行
板信商業銀行	0 	21 	0 	21 	2021	Q4	2021-Q4	21-Dec	民營銀行
三信商業銀行	212 	0 	177 	389 	2021	Q4	2021-Q4	21-Dec	民營銀行
聯邦商業銀行	66211 	0 	246797 	313008 	2021	Q4	2021-Q4	21-Dec	民營銀行
遠東國際商業銀行	11495 	12150 	93293 	116938 	2021	Q4	2021-Q4	21-Dec	民營銀行
元大商業銀行	214 	2376 	6320 	8910 	2021	Q4	2021-Q4	21-Dec	民營銀行
永豐商業銀行	402236 	243807 	439656 	1085699 	2021	Q4	2021-Q4	21-Dec	民營銀行
玉山商業銀行	89330 	45742 	164894 	299966 	2021	Q4	2021-Q4	21-Dec	民營銀行
凱基商業銀行	509 	0 	19229 	19738 	2021	Q4	2021-Q4	21-Dec	民營銀行
星展(台灣)商業銀行	0 	0 	5333 	5333 	2021	Q4	2021-Q4	21-Dec	民營銀行
台新國際商業銀行	1109729 	634097 	1003677 	2747503 	2021	Q4	2021-Q4	21-Dec	民營銀行
日盛國際商業銀行	0 	96 	59 	155 	2021	Q4	2021-Q4	21-Dec	民營銀行
安泰商業銀行	1141 	1532 	3192 	5865 	2021	Q4	2021-Q4	21-Dec	民營銀行
中國信託商業銀行	40231 	223894 	310646 	574771 	2021	Q4	2021-Q4	21-Dec	民營銀行
連線商業銀行	17303 	0 	715335 	732638 	2021	Q4	2021-Q4	21-Dec	純網銀
樂天國際商業銀行	12564 	0 	54640 	67204 	2021	Q4	2021-Q4	21-Dec	純網銀
臺灣銀行	8982 	21265 	683 	30930 	2021	Q3	2021-Q3	21-Sep	公股行庫
臺灣土地銀行	7208 	48069 	35381 	90658 	2021	Q3	2021-Q3	21-Sep	公股行庫
合作金庫商業銀行	14894 	58512 	184240 	257646 	2021	Q3	2021-Q3	21-Sep	公股行庫
第一商業銀行	97368 	466758 	176212 	740338 	2021	Q3	2021-Q3	21-Sep	公股行庫
華南商業銀行	14835 	294004 	23129 	331968 	2021	Q3	2021-Q3	21-Sep	公股行庫
彰化商業銀行	111234 	69881 	124184 	305299 	2021	Q3	2021-Q3	21-Sep	公股行庫
上海商業儲蓄銀行	1749 	16003 	38723 	56475 	2021	Q3	2021-Q3	21-Sep	民營銀行
台北富邦商業銀行	16062 	38009 	124951 	179022 	2021	Q3	2021-Q3	21-Sep	民營銀行
國泰世華商業銀行	227987 	971347 	176627 	1375961 	2021	Q3	2021-Q3	21-Sep	民營銀行
高雄銀行	42 	1404 	8720 	10166 	2021	Q3	2021-Q3	21-Sep	民營銀行
兆豐國際商業銀行	24797 	46691 	46684 	118172 	2021	Q3	2021-Q3	21-Sep	公股行庫
花旗(台灣)商業銀行	2414 	0 	6195 	8609 	2021	Q3	2021-Q3	21-Sep	民營銀行
王道商業銀行	79606 	0 	387450 	467056 	2021	Q3	2021-Q3	21-Sep	民營銀行
臺灣中小企業銀行	6935 	9933 	7105 	23973 	2021	Q3	2021-Q3	21-Sep	公股行庫
渣打國際商業銀行	5662 	1268 	21890 	28820 	2021	Q3	2021-Q3	21-Sep	民營銀行
台中商業銀行	0 	116 	0 	116 	2021	Q3	2021-Q3	21-Sep	民營銀行
京城商業銀行	521 	1336 	10264 	12121 	2021	Q3	2021-Q3	21-Sep	民營銀行
?豐(台灣)商業銀行	9252 	0 	3844 	13096 	2021	Q3	2021-Q3	21-Sep	民營銀行
瑞興商業銀行	53 	0 	492 	545 	2021	Q3	2021-Q3	21-Sep	民營銀行
華泰商業銀行	20 	0 	69 	89 	2021	Q3	2021-Q3	21-Sep	民營銀行
臺灣新光商業銀行	4282 	1179 	74024 	79485 	2021	Q3	2021-Q3	21-Sep	民營銀行
陽信商業銀行	938 	1625 	602 	3165 	2021	Q3	2021-Q3	21-Sep	民營銀行
板信商業銀行	0 	21 	0 	21 	2021	Q3	2021-Q3	21-Sep	民營銀行
三信商業銀行	189 	0 	124 	313 	2021	Q3	2021-Q3	21-Sep	民營銀行
聯邦商業銀行	61529 	0 	231620 	293149 	2021	Q3	2021-Q3	21-Sep	民營銀行
遠東國際商業銀行	2261 	10843 	83009 	96113 	2021	Q3	2021-Q3	21-Sep	民營銀行
元大商業銀行	168 	1445 	4407 	6020 	2021	Q3	2021-Q3	21-Sep	民營銀行
永豐商業銀行	358452 	227968 	419403 	1005823 	2021	Q3	2021-Q3	21-Sep	民營銀行
玉山商業銀行	84717 	19236 	119481 	223434 	2021	Q3	2021-Q3	21-Sep	民營銀行
凱基商業銀行	511 	0 	12885 	13396 	2021	Q3	2021-Q3	21-Sep	民營銀行
星展(台灣)商業銀行	0 	0 	5057 	5057 	2021	Q3	2021-Q3	21-Sep	民營銀行
台新國際商業銀行	1072040 	615804 	987994 	2675838 	2021	Q3	2021-Q3	21-Sep	民營銀行
日盛國際商業銀行	0 	93 	59 	152 	2021	Q3	2021-Q3	21-Sep	民營銀行
安泰商業銀行	1022 	1506 	3170 	5698 	2021	Q3	2021-Q3	21-Sep	民營銀行
中國信託商業銀行	33485 	204187 	266722 	504394 	2021	Q3	2021-Q3	21-Sep	民營銀行
連線商業銀行	8626 	0 	403817 	412443 	2021	Q3	2021-Q3	21-Sep	純網銀
樂天國際商業銀行	10438 	0 	46312 	56750 	2021	Q3	2021-Q3	21-Sep	純網銀
臺灣銀行	8427 	16224 	0 	24651 	2021	Q2	2021-Q2	21-Jun	公股行庫
臺灣土地銀行	6025 	38317 	27146 	71488 	2021	Q2	2021-Q2	21-Jun	公股行庫
合作金庫商業銀行	14046 	37692 	149041 	200779 	2021	Q2	2021-Q2	21-Jun	公股行庫
第一商業銀行	78352 	415188 	153352 	646892 	2021	Q2	2021-Q2	21-Jun	公股行庫
華南商業銀行	13041 	256730 	16580 	286351 	2021	Q2	2021-Q2	21-Jun	公股行庫
彰化商業銀行	85060 	60694 	101538 	247292 	2021	Q2	2021-Q2	21-Jun	公股行庫
上海商業儲蓄銀行	1751 	13840 	32221 	47812 	2021	Q2	2021-Q2	21-Jun	民營銀行
台北富邦商業銀行	14149 	36252 	106501 	156902 	2021	Q2	2021-Q2	21-Jun	民營銀行
國泰世華商業銀行	206234 	967081 	97519 	1270834 	2021	Q2	2021-Q2	21-Jun	民營銀行
高雄銀行	0 	0 	4850 	4850 	2021	Q2	2021-Q2	21-Jun	民營銀行
兆豐國際商業銀行	23870 	44315 	42732 	110917 	2021	Q2	2021-Q2	21-Jun	公股行庫
花旗(台灣)商業銀行	1993 	0 	4529 	6522 	2021	Q2	2021-Q2	21-Jun	民營銀行
王道商業銀行	78583 	0 	383483 	462066 	2021	Q2	2021-Q2	21-Jun	民營銀行
臺灣中小企業銀行	6334 	8916 	1537 	16787 	2021	Q2	2021-Q2	21-Jun	公股行庫
渣打國際商業銀行	5471 	1211 	18674 	25356 	2021	Q2	2021-Q2	21-Jun	民營銀行
台中商業銀行	0 	117 	0 	117 	2021	Q2	2021-Q2	21-Jun	民營銀行
京城商業銀行	473 	978 	7688 	9139 	2021	Q2	2021-Q2	21-Jun	民營銀行
?豐(台灣)商業銀行	7033 	0 	1886 	8919 	2021	Q2	2021-Q2	21-Jun	民營銀行
瑞興商業銀行	12 	0 	151 	163 	2021	Q2	2021-Q2	21-Jun	民營銀行
華泰商業銀行	20 	0 	62 	82 	2021	Q2	2021-Q2	21-Jun	民營銀行
臺灣新光商業銀行	4055 	1206 	51002 	56263 	2021	Q2	2021-Q2	21-Jun	民營銀行
陽信商業銀行	902 	1561 	404 	2867 	2021	Q2	2021-Q2	21-Jun	民營銀行
板信商業銀行	0 	21 	0 	21 	2021	Q2	2021-Q2	21-Jun	民營銀行
聯邦商業銀行	54804 	0 	198469 	253273 	2021	Q2	2021-Q2	21-Jun	民營銀行
遠東國際商業銀行	1515 	9379 	68486 	79380 	2021	Q2	2021-Q2	21-Jun	民營銀行
元大商業銀行	12 	166 	1314 	1492 	2021	Q2	2021-Q2	21-Jun	民營銀行
永豐商業銀行	311269 	206994 	376071 	894334 	2021	Q2	2021-Q2	21-Jun	民營銀行
玉山商業銀行	79397 	3231 	76684 	159312 	2021	Q2	2021-Q2	21-Jun	民營銀行
凱基商業銀行	515 	0 	6760 	7275 	2021	Q2	2021-Q2	21-Jun	民營銀行
星展(台灣)商業銀行	0 	0 	14752 	14752 	2021	Q2	2021-Q2	21-Jun	民營銀行
台新國際商業銀行	1026426 	594476 	971012 	2591914 	2021	Q2	2021-Q2	21-Jun	民營銀行
日盛國際商業銀行	0 	91 	59 	150 	2021	Q2	2021-Q2	21-Jun	民營銀行
安泰商業銀行	902 	1500 	3128 	5530 	2021	Q2	2021-Q2	21-Jun	民營銀行
中國信託商業銀行	28938 	193546 	212692 	435176 	2021	Q2	2021-Q2	21-Jun	民營銀行
連線商業銀行	6812 	0 	153042 	159854 	2021	Q2	2021-Q2	21-Jun	純網銀
樂天國際商業銀行	8170 	0 	52300 	60470 	2021	Q2	2021-Q2	21-Jun	純網銀
臺灣銀行	7891 	14064 	0 	21955 	2021	Q1	2021-Q1	21-Mar	公股行庫
臺灣土地銀行	5168 	30222 	20972 	56362 	2021	Q1	2021-Q1	21-Mar	公股行庫
合作金庫商業銀行	13345 	29477 	106776 	149598 	2021	Q1	2021-Q1	21-Mar	公股行庫
第一商業銀行	62242 	367582 	120410 	550234 	2021	Q1	2021-Q1	21-Mar	公股行庫
華南商業銀行	12254 	223161 	13460 	248875 	2021	Q1	2021-Q1	21-Mar	公股行庫
彰化商業銀行	62692 	50289 	82434 	195415 	2021	Q1	2021-Q1	21-Mar	公股行庫
上海商業儲蓄銀行	1751 	11806 	25653 	39210 	2021	Q1	2021-Q1	21-Mar	民營銀行
台北富邦商業銀行	11743 	33141 	85003 	129887 	2021	Q1	2021-Q1	21-Mar	民營銀行
國泰世華商業銀行	192203 	869161 	62381 	1123745 	2021	Q1	2021-Q1	21-Mar	民營銀行
高雄銀行	0 	0 	3364 	3364 	2021	Q1	2021-Q1	21-Mar	民營銀行
兆豐國際商業銀行	22659 	41287 	38289 	102235 	2021	Q1	2021-Q1	21-Mar	公股行庫
花旗(台灣)商業銀行	1763 	0 	3356 	5119 	2021	Q1	2021-Q1	21-Mar	民營銀行
王道商業銀行	77609 	0 	379680 	457289 	2021	Q1	2021-Q1	21-Mar	民營銀行
臺灣中小企業銀行	4900 	6998 	0 	11898 	2021	Q1	2021-Q1	21-Mar	公股行庫
渣打國際商業銀行	5335 	1144 	16412 	22891 	2021	Q1	2021-Q1	21-Mar	民營銀行
台中商業銀行	0 	119 	0 	119 	2021	Q1	2021-Q1	21-Mar	民營銀行
京城商業銀行	255 	533 	4752 	5540 	2021	Q1	2021-Q1	21-Mar	民營銀行
?豐(台灣)商業銀行	4778 	0 	0 	4778 	2021	Q1	2021-Q1	21-Mar	民營銀行
瑞興商業銀行	12 	0 	128 	140 	2021	Q1	2021-Q1	21-Mar	民營銀行
華泰商業銀行	18 	0 	57 	75 	2021	Q1	2021-Q1	21-Mar	民營銀行
臺灣新光商業銀行	2652 	1220 	26043 	29915 	2021	Q1	2021-Q1	21-Mar	民營銀行
陽信商業銀行	857 	1486 	216 	2559 	2021	Q1	2021-Q1	21-Mar	民營銀行
板信商業銀行	0 	20 	0 	20 	2021	Q1	2021-Q1	21-Mar	民營銀行
聯邦商業銀行	47545 	0 	173640 	221185 	2021	Q1	2021-Q1	21-Mar	民營銀行
遠東國際商業銀行	1048 	7718 	52822 	61588 	2021	Q1	2021-Q1	21-Mar	民營銀行
元大商業銀行	12 	166 	1314 	1492 	2021	Q1	2021-Q1	21-Mar	民營銀行
永豐商業銀行	262778 	185041 	343300 	791119 	2021	Q1	2021-Q1	21-Mar	民營銀行
玉山商業銀行	71056 	0 	58098 	129154 	2021	Q1	2021-Q1	21-Mar	民營銀行
凱基商業銀行	518 	0 	2557 	3075 	2021	Q1	2021-Q1	21-Mar	民營銀行
星展(台灣)商業銀行	0 	0 	14188 	14188 	2021	Q1	2021-Q1	21-Mar	民營銀行
台新國際商業銀行	982772 	569569 	944357 	2496698 	2021	Q1	2021-Q1	21-Mar	民營銀行
日盛國際商業銀行	0 	83 	59 	142 	2021	Q1	2021-Q1	21-Mar	民營銀行
安泰商業銀行	778 	1478 	3102 	5358 	2021	Q1	2021-Q1	21-Mar	民營銀行
中國信託商業銀行	25609 	168448 	166544 	360601 	2021	Q1	2021-Q1	21-Mar	民營銀行
連線商業銀行	287 	0 	273 	560 	2021	Q1	2021-Q1	21-Mar	純網銀
樂天國際商業銀行	4435 	0 	32470 	36905 	2021	Q1	2021-Q1	21-Mar	純網銀
臺灣銀行	7587 	13196 	0 	20783 	2020	Q4	2020-Q4	20-Dec	公股行庫
臺灣土地銀行	2064 	19345 	116 	21525 	2020	Q4	2020-Q4	20-Dec	公股行庫
合作金庫商業銀行	12840 	27799 	84370 	125009 	2020	Q4	2020-Q4	20-Dec	公股行庫
第一商業銀行	45846 	310100 	94438 	450384 	2020	Q4	2020-Q4	20-Dec	公股行庫
華南商業銀行	11202 	186937 	10187 	208326 	2020	Q4	2020-Q4	20-Dec	公股行庫
彰化商業銀行	40353 	34804 	52506 	127663 	2020	Q4	2020-Q4	20-Dec	公股行庫
上海商業儲蓄銀行	1752 	8398 	16989 	27139 	2020	Q4	2020-Q4	20-Dec	民營銀行
台北富邦商業銀行	9790 	29344 	67413 	106547 	2020	Q4	2020-Q4	20-Dec	民營銀行
國泰世華商業銀行	177323 	742977 	46689 	966989 	2020	Q4	2020-Q4	20-Dec	民營銀行
高雄銀行	0 	0 	1682 	1682 	2020	Q4	2020-Q4	20-Dec	民營銀行
兆豐國際商業銀行	21346 	36865 	34106 	92317 	2020	Q4	2020-Q4	20-Dec	公股行庫
花旗(台灣)商業銀行	1438 	0 	2432 	3870 	2020	Q4	2020-Q4	20-Dec	民營銀行
王道商業銀行	76620 	0 	375399 	452019 	2020	Q4	2020-Q4	20-Dec	民營銀行
臺灣中小企業銀行	1212 	4299 	0 	5511 	2020	Q4	2020-Q4	20-Dec	公股行庫
渣打國際商業銀行	5187 	1105 	14922 	21214 	2020	Q4	2020-Q4	20-Dec	民營銀行
台中商業銀行	0 	123 	0 	123 	2020	Q4	2020-Q4	20-Dec	民營銀行
京城商業銀行	183 	255 	3752 	4190 	2020	Q4	2020-Q4	20-Dec	民營銀行
?豐(台灣)商業銀行	1641 	0 	0 	1641 	2020	Q4	2020-Q4	20-Dec	民營銀行
瑞興商業銀行	10 	0 	139 	149 	2020	Q4	2020-Q4	20-Dec	民營銀行
華泰商業銀行	17 	0 	53 	70 	2020	Q4	2020-Q4	20-Dec	民營銀行
臺灣新光商業銀行	1887 	1956 	12627 	16470 	2020	Q4	2020-Q4	20-Dec	民營銀行
陽信商業銀行	825 	1404 	62 	2291 	2020	Q4	2020-Q4	20-Dec	民營銀行
板信商業銀行	0 	21 	0 	21 	2020	Q4	2020-Q4	20-Dec	民營銀行
聯邦商業銀行	65697 	0 	257795 	323492 	2020	Q4	2020-Q4	20-Dec	民營銀行
遠東國際商業銀行	699 	5770 	35481 	41950 	2020	Q4	2020-Q4	20-Dec	民營銀行
元大商業銀行	9 	122 	751 	882 	2020	Q4	2020-Q4	20-Dec	民營銀行
永豐商業銀行	208617 	155406 	299674 	663697 	2020	Q4	2020-Q4	20-Dec	民營銀行
玉山商業銀行	61078 	0 	49393 	110471 	2020	Q4	2020-Q4	20-Dec	民營銀行
凱基商業銀行	522 	0 	889 	1411 	2020	Q4	2020-Q4	20-Dec	民營銀行
星展(台灣)商業銀行	0 	0 	13882 	13882 	2020	Q4	2020-Q4	20-Dec	民營銀行
台新國際商業銀行	930368 	538353 	900031 	2368752 	2020	Q4	2020-Q4	20-Dec	民營銀行
日盛國際商業銀行	0 	78 	59 	137 	2020	Q4	2020-Q4	20-Dec	民營銀行
安泰商業銀行	690 	1460 	3088 	5238 	2020	Q4	2020-Q4	20-Dec	民營銀行
中國信託商業銀行	21275 	137090 	118833 	277198 	2020	Q4	2020-Q4	20-Dec	民營銀行
樂天國際商業銀行	17 	0 	38 	55 	2020	Q4	2020-Q4	20-Dec	純網銀
臺灣銀行	6982 	9689 	0 	16671 	2020	Q3	2020-Q3	20-Sep	公股行庫
臺灣土地銀行	398 	1208 	0 	1606 	2020	Q3	2020-Q3	20-Sep	公股行庫
合作金庫商業銀行	12617 	26511 	70749 	109877 	2020	Q3	2020-Q3	20-Sep	公股行庫
第一商業銀行	35004 	266342 	78946 	380292 	2020	Q3	2020-Q3	20-Sep	公股行庫
華南商業銀行	10577 	160076 	7974 	178627 	2020	Q3	2020-Q3	20-Sep	公股行庫
彰化商業銀行	33458 	31765 	44666 	109889 	2020	Q3	2020-Q3	20-Sep	公股行庫
上海商業儲蓄銀行	1755 	6629 	12724 	21108 	2020	Q3	2020-Q3	20-Sep	民營銀行
台北富邦商業銀行	7814 	24058 	47441 	79313 	2020	Q3	2020-Q3	20-Sep	民營銀行
國泰世華商業銀行	161821 	635461 	37834 	835116 	2020	Q3	2020-Q3	20-Sep	民營銀行
兆豐國際商業銀行	20823 	34715 	31870 	87408 	2020	Q3	2020-Q3	20-Sep	公股行庫
花旗(台灣)商業銀行	1345 	0 	1533 	2878 	2020	Q3	2020-Q3	20-Sep	民營銀行
王道商業銀行	75934 	0 	371300 	447234 	2020	Q3	2020-Q3	20-Sep	民營銀行
臺灣中小企業銀行	1148 	4271 	0 	5419 	2020	Q3	2020-Q3	20-Sep	公股行庫
渣打國際商業銀行	5080 	1030 	13359 	19469 	2020	Q3	2020-Q3	20-Sep	民營銀行
台中商業銀行	0 	124 	0 	124 	2020	Q3	2020-Q3	20-Sep	民營銀行
京城商業銀行	0 	0 	3336 	3336 	2020	Q3	2020-Q3	20-Sep	民營銀行
?豐(台灣)商業銀行	459 	0 	0 	459 	2020	Q3	2020-Q3	20-Sep	民營銀行
瑞興商業銀行	0 	0 	28 	28 	2020	Q3	2020-Q3	20-Sep	民營銀行
華泰商業銀行	17 	0 	48 	65 	2020	Q3	2020-Q3	20-Sep	民營銀行
臺灣新光商業銀行	1347 	1860 	5005 	8212 	2020	Q3	2020-Q3	20-Sep	民營銀行
陽信商業銀行	813 	1357 	31 	2201 	2020	Q3	2020-Q3	20-Sep	民營銀行
板信商業銀行	0 	20 	0 	20 	2020	Q3	2020-Q3	20-Sep	民營銀行
聯邦商業銀行	56185 	0 	202898 	259083 	2020	Q3	2020-Q3	20-Sep	民營銀行
遠東國際商業銀行	495 	4571 	24807 	29873 	2020	Q3	2020-Q3	20-Sep	民營銀行
元大商業銀行	9 	122 	488 	619 	2020	Q3	2020-Q3	20-Sep	民營銀行
永豐商業銀行	171436 	134102 	276031 	581569 	2020	Q3	2020-Q3	20-Sep	民營銀行
玉山商業銀行	52500 	0 	40024 	92524 	2020	Q3	2020-Q3	20-Sep	民營銀行
凱基商業銀行	523 	0 	408 	931 	2020	Q3	2020-Q3	20-Sep	民營銀行
星展(台灣)商業銀行	0 	0 	13941 	13941 	2020	Q3	2020-Q3	20-Sep	民營銀行
台新國際商業銀行	883063 	508836 	857582 	2249481 	2020	Q3	2020-Q3	20-Sep	民營銀行
日盛國際商業銀行	0 	73 	61 	134 	2020	Q3	2020-Q3	20-Sep	民營銀行
安泰商業銀行	578 	1432 	3054 	5064 	2020	Q3	2020-Q3	20-Sep	民營銀行
中國信託商業銀行	19000 	108621 	82315 	209936 	2020	Q3	2020-Q3	20-Sep	民營銀行
臺灣銀行	6287 	7302 	0 	13589 	2020	Q2	2020-Q2	20-Jun	公股行庫
臺灣土地銀行	302 	134 	0 	436 	2020	Q2	2020-Q2	20-Jun	公股行庫
合作金庫商業銀行	11952 	23728 	47289 	82969 	2020	Q2	2020-Q2	20-Jun	公股行庫
第一商業銀行	25240 	224106 	64144 	313490 	2020	Q2	2020-Q2	20-Jun	公股行庫
華南商業銀行	9715 	134542 	4959 	149216 	2020	Q2	2020-Q2	20-Jun	公股行庫
彰化商業銀行	25543 	29532 	38514 	93589 	2020	Q2	2020-Q2	20-Jun	公股行庫
上海商業儲蓄銀行	1755 	3807 	4989 	10551 	2020	Q2	2020-Q2	20-Jun	民營銀行
台北富邦商業銀行	4943 	16207 	23415 	44565 	2020	Q2	2020-Q2	20-Jun	民營銀行
國泰世華商業銀行	146577 	511449 	22304 	680330 	2020	Q2	2020-Q2	20-Jun	民營銀行
兆豐國際商業銀行	19745 	31572 	27852 	79169 	2020	Q2	2020-Q2	20-Jun	公股行庫
花旗(台灣)商業銀行	1348 	0 	438 	1786 	2020	Q2	2020-Q2	20-Jun	民營銀行
王道商業銀行	74987 	0 	366958 	441945 	2020	Q2	2020-Q2	20-Jun	民營銀行
臺灣中小企業銀行	1044 	4229 	0 	5273 	2020	Q2	2020-Q2	20-Jun	公股行庫
渣打國際商業銀行	4806 	955 	10207 	15968 	2020	Q2	2020-Q2	20-Jun	民營銀行
台中商業銀行	0 	126 	0 	126 	2020	Q2	2020-Q2	20-Jun	民營銀行
京城商業銀行	0 	0 	2650 	2650 	2020	Q2	2020-Q2	20-Jun	民營銀行
?豐(台灣)商業銀行	7 	0 	0 	7 	2020	Q2	2020-Q2	20-Jun	民營銀行
瑞興商業銀行	0 	0 	31 	31 	2020	Q2	2020-Q2	20-Jun	民營銀行
華泰商業銀行	17 	0 	46 	63 	2020	Q2	2020-Q2	20-Jun	民營銀行
臺灣新光商業銀行	1182 	1694 	3315 	6191 	2020	Q2	2020-Q2	20-Jun	民營銀行
陽信商業銀行	800 	1278 	0 	2078 	2020	Q2	2020-Q2	20-Jun	民營銀行
板信商業銀行	0 	20 	0 	20 	2020	Q2	2020-Q2	20-Jun	民營銀行
聯邦商業銀行	28967 	0 	109045 	138012 	2020	Q2	2020-Q2	20-Jun	民營銀行
遠東國際商業銀行	304 	2914 	13536 	16754 	2020	Q2	2020-Q2	20-Jun	民營銀行
元大商業銀行	8 	108 	223 	339 	2020	Q2	2020-Q2	20-Jun	民營銀行
永豐商業銀行	131888 	109358 	230443 	471689 	2020	Q2	2020-Q2	20-Jun	民營銀行
玉山商業銀行	41104 	0 	28265 	69369 	2020	Q2	2020-Q2	20-Jun	民營銀行
凱基商業銀行	524 	0 	29 	553 	2020	Q2	2020-Q2	20-Jun	民營銀行
星展(台灣)商業銀行	0 	0 	13635 	13635 	2020	Q2	2020-Q2	20-Jun	民營銀行
台新國際商業銀行	827521 	476535 	809419 	2113475 	2020	Q2	2020-Q2	20-Jun	民營銀行
日盛國際商業銀行	0 	60 	63 	123 	2020	Q2	2020-Q2	20-Jun	民營銀行
安泰商業銀行	462 	1424 	3004 	4890 	2020	Q2	2020-Q2	20-Jun	民營銀行
中國信託商業銀行	16817 	79548 	51994 	148359 	2020	Q2	2020-Q2	20-Jun	民營銀行
臺灣銀行	560 	565 	0 	1125 	2020	Q1	2020-Q1	20-Mar	公股行庫
臺灣土地銀行	240 	127 	0 	367 	2020	Q1	2020-Q1	20-Mar	公股行庫
合作金庫商業銀行	10223 	16723 	652 	27598 	2020	Q1	2020-Q1	20-Mar	公股行庫
第一商業銀行	8616 	158592 	37648 	204856 	2020	Q1	2020-Q1	20-Mar	公股行庫
華南商業銀行	8957 	100494 	2166 	111617 	2020	Q1	2020-Q1	20-Mar	公股行庫
彰化商業銀行	13472 	21275 	25482 	60229 	2020	Q1	2020-Q1	20-Mar	公股行庫
上海商業儲蓄銀行	1757 	1596 	1326 	4679 	2020	Q1	2020-Q1	20-Mar	民營銀行
台北富邦商業銀行	3325 	6818 	14196 	24339 	2020	Q1	2020-Q1	20-Mar	民營銀行
國泰世華商業銀行	135778 	433628 	14911 	584317 	2020	Q1	2020-Q1	20-Mar	民營銀行
兆豐國際商業銀行	17956 	25235 	22371 	65562 	2020	Q1	2020-Q1	20-Mar	公股行庫
花旗(台灣)商業銀行	1330 	0 	0 	1330 	2020	Q1	2020-Q1	20-Mar	民營銀行
王道商業銀行	73214 	0 	361953 	435167 	2020	Q1	2020-Q1	20-Mar	民營銀行
臺灣中小企業銀行	965 	4158 	0 	5123 	2020	Q1	2020-Q1	20-Mar	公股行庫
渣打國際商業銀行	4446 	810 	4936 	10192 	2020	Q1	2020-Q1	20-Mar	民營銀行
台中商業銀行	0 	126 	0 	126 	2020	Q1	2020-Q1	20-Mar	民營銀行
京城商業銀行	0 	0 	1422 	1422 	2020	Q1	2020-Q1	20-Mar	民營銀行
瑞興商業銀行	0 	0 	15 	15 	2020	Q1	2020-Q1	20-Mar	民營銀行
華泰商業銀行	16 	0 	41 	57 	2020	Q1	2020-Q1	20-Mar	民營銀行
臺灣新光商業銀行	1131 	1609 	2953 	5693 	2020	Q1	2020-Q1	20-Mar	民營銀行
陽信商業銀行	698 	875 	0 	1573 	2020	Q1	2020-Q1	20-Mar	民營銀行
板信商業銀行	0 	20 	0 	20 	2020	Q1	2020-Q1	20-Mar	民營銀行
聯邦商業銀行	21478 	0 	67292 	88770 	2020	Q1	2020-Q1	20-Mar	民營銀行
遠東國際商業銀行	64 	1269 	3830 	5163 	2020	Q1	2020-Q1	20-Mar	民營銀行
元大商業銀行	8 	104 	227 	339 	2020	Q1	2020-Q1	20-Mar	民營銀行
永豐商業銀行	92665 	84343 	194608 	371616 	2020	Q1	2020-Q1	20-Mar	民營銀行
玉山商業銀行	30939 	0 	17208 	48147 	2020	Q1	2020-Q1	20-Mar	民營銀行
凱基商業銀行	529 	0 	0 	529 	2020	Q1	2020-Q1	20-Mar	民營銀行
星展(台灣)商業銀行	0 	0 	13521 	13521 	2020	Q1	2020-Q1	20-Mar	民營銀行
台新國際商業銀行	771859 	445978 	770078 	1987915 	2020	Q1	2020-Q1	20-Mar	民營銀行
日盛國際商業銀行	0 	55 	64 	119 	2020	Q1	2020-Q1	20-Mar	民營銀行
安泰商業銀行	164 	1248 	1480 	2892 	2020	Q1	2020-Q1	20-Mar	民營銀行
中國信託商業銀行	14329 	40901 	29921 	85151 	2020	Q1	2020-Q1	20-Mar	民營銀行
臺灣銀行	456 	378 	0 	834 	2019	Q4	2019-Q4	19-Dec	公股行庫
臺灣土地銀行	208 	117 	0 	325 	2019	Q4	2019-Q4	19-Dec	公股行庫
合作金庫商業銀行	8426 	12181 	0 	20607 	2019	Q4	2019-Q4	19-Dec	公股行庫
第一商業銀行	3218 	107700 	24150 	135068 	2019	Q4	2019-Q4	19-Dec	公股行庫
華南商業銀行	8333 	73149 	0 	81482 	2019	Q4	2019-Q4	19-Dec	公股行庫
彰化商業銀行	6247 	15048 	10598 	31893 	2019	Q4	2019-Q4	19-Dec	公股行庫
上海商業儲蓄銀行	1267 	451 	0 	1718 	2019	Q4	2019-Q4	19-Dec	民營銀行
台北富邦商業銀行	2516 	3751 	7761 	14028 	2019	Q4	2019-Q4	19-Dec	民營銀行
國泰世華商業銀行	124301 	332113 	8489 	464903 	2019	Q4	2019-Q4	19-Dec	民營銀行
兆豐國際商業銀行	16890 	21460 	19610 	57960 	2019	Q4	2019-Q4	19-Dec	公股行庫
花旗(台灣)商業銀行	1336 	0 	0 	1336 	2019	Q4	2019-Q4	19-Dec	民營銀行
王道商業銀行	70850 	0 	353092 	423942 	2019	Q4	2019-Q4	19-Dec	民營銀行
臺灣中小企業銀行	894 	4133 	0 	5027 	2019	Q4	2019-Q4	19-Dec	公股行庫
渣打國際商業銀行	4288 	701 	2647 	7636 	2019	Q4	2019-Q4	19-Dec	民營銀行
台中商業銀行	0 	127 	0 	127 	2019	Q4	2019-Q4	19-Dec	民營銀行
華泰商業銀行	13 	0 	40 	53 	2019	Q4	2019-Q4	19-Dec	民營銀行
臺灣新光商業銀行	1011 	1520 	2601 	5132 	2019	Q4	2019-Q4	19-Dec	民營銀行
陽信商業銀行	529 	792 	0 	1321 	2019	Q4	2019-Q4	19-Dec	民營銀行
板信商業銀行	0 	19 	0 	19 	2019	Q4	2019-Q4	19-Dec	民營銀行
聯邦商業銀行	2679 	0 	7519 	10198 	2019	Q4	2019-Q4	19-Dec	民營銀行
遠東國際商業銀行	19 	690 	1838 	2547 	2019	Q4	2019-Q4	19-Dec	民營銀行
元大商業銀行	8 	98 	194 	300 	2019	Q4	2019-Q4	19-Dec	民營銀行
永豐商業銀行	52472 	46673 	125374 	224519 	2019	Q4	2019-Q4	19-Dec	民營銀行
玉山商業銀行	24588 	0 	12282 	36870 	2019	Q4	2019-Q4	19-Dec	民營銀行
凱基商業銀行	531 	0 	0 	531 	2019	Q4	2019-Q4	19-Dec	民營銀行
星展(台灣)商業銀行	0 	0 	13436 	13436 	2019	Q4	2019-Q4	19-Dec	民營銀行
台新國際商業銀行	700344 	399421 	693268 	1793033 	2019	Q4	2019-Q4	19-Dec	民營銀行
日盛國際商業銀行	0 	50 	64 	114 	2019	Q4	2019-Q4	19-Dec	民營銀行
安泰商業銀行	4 	202 	8 	214 	2019	Q4	2019-Q4	19-Dec	民營銀行
中國信託商業銀行	12800 	15784 	19548 	48132 	2019	Q4	2019-Q4	19-Dec	民營銀行
臺灣銀行	385 	191 	0 	576 	2019	Q3	2019-Q3	19-Sep	公股行庫
臺灣土地銀行	181 	114 	0 	295 	2019	Q3	2019-Q3	19-Sep	公股行庫
合作金庫商業銀行	7141 	8966 	0 	16107 	2019	Q3	2019-Q3	19-Sep	公股行庫
第一商業銀行	1356 	64220 	13688 	79264 	2019	Q3	2019-Q3	19-Sep	公股行庫
華南商業銀行	8123 	71348 	0 	79471 	2019	Q3	2019-Q3	19-Sep	公股行庫
彰化商業銀行	4396 	12601 	6764 	23761 	2019	Q3	2019-Q3	19-Sep	公股行庫
上海商業儲蓄銀行	1193 	400 	0 	1593 	2019	Q3	2019-Q3	19-Sep	民營銀行
台北富邦商業銀行	2101 	2980 	5418 	10499 	2019	Q3	2019-Q3	19-Sep	民營銀行
國泰世華商業銀行	112273 	266452 	1180 	379905 	2019	Q3	2019-Q3	19-Sep	民營銀行
兆豐國際商業銀行	16273 	19642 	17765 	53680 	2019	Q3	2019-Q3	19-Sep	公股行庫
花旗(台灣)商業銀行	1342 	0 	0 	1342 	2019	Q3	2019-Q3	19-Sep	民營銀行
王道商業銀行	67194 	0 	317957 	385151 	2019	Q3	2019-Q3	19-Sep	民營銀行
臺灣中小企業銀行	884 	4217 	0 	5101 	2019	Q3	2019-Q3	19-Sep	公股行庫
渣打國際商業銀行	4118 	621 	1816 	6555 	2019	Q3	2019-Q3	19-Sep	民營銀行
台中商業銀行	0 	127 	0 	127 	2019	Q3	2019-Q3	19-Sep	民營銀行
臺灣新光商業銀行	878 	1480 	1850 	4208 	2019	Q3	2019-Q3	19-Sep	民營銀行
陽信商業銀行	482 	744 	0 	1226 	2019	Q3	2019-Q3	19-Sep	民營銀行
板信商業銀行	0 	20 	0 	20 	2019	Q3	2019-Q3	19-Sep	民營銀行
聯邦商業銀行	1612 	0 	4715 	6327 	2019	Q3	2019-Q3	19-Sep	民營銀行
遠東國際商業銀行	0 	517 	1224 	1741 	2019	Q3	2019-Q3	19-Sep	民營銀行
元大商業銀行	8 	95 	167 	270 	2019	Q3	2019-Q3	19-Sep	民營銀行
永豐商業銀行	27358 	1146 	88890 	117394 	2019	Q3	2019-Q3	19-Sep	民營銀行
玉山商業銀行	14743 	0 	7357 	22100 	2019	Q3	2019-Q3	19-Sep	民營銀行
凱基商業銀行	539 	0 	0 	539 	2019	Q3	2019-Q3	19-Sep	民營銀行
星展(台灣)商業銀行	0 	0 	12577 	12577 	2019	Q3	2019-Q3	19-Sep	民營銀行
台新國際商業銀行	628145 	345801 	605968 	1579914 	2019	Q3	2019-Q3	19-Sep	民營銀行
日盛國際商業銀行	0 	45 	66 	111 	2019	Q3	2019-Q3	19-Sep	民營銀行
安泰商業銀行	2 	184 	2 	188 	2019	Q3	2019-Q3	19-Sep	民營銀行
中國信託商業銀行	11800 	9013 	13832 	34645 	2019	Q3	2019-Q3	19-Sep	民營銀行
